"filename", "language", "PHP", "Markdown", "CSS", "JavaScript", "comment", "blank", "total"
"d:\MyProject\Git项目中心\Github\WEB相关\iapp-doc\README.md", "Markdown", 0, 41, 0, 0, 0, 14, 55
"d:\MyProject\Git项目中心\Github\WEB相关\iapp-doc\about.php", "PHP", 24, 0, 0, 0, 3, 5, 32
"d:\MyProject\Git项目中心\Github\WEB相关\iapp-doc\article.php", "PHP", 77, 0, 0, 0, 3, 3, 83
"d:\MyProject\Git项目中心\Github\WEB相关\iapp-doc\book.php", "PHP", 78, 0, 0, 0, 6, 5, 89
"d:\MyProject\Git项目中心\Github\WEB相关\iapp-doc\config.php", "PHP", 18, 0, 0, 0, 13, 2, 33
"d:\MyProject\Git项目中心\Github\WEB相关\iapp-doc\css\prism.css", "CSS", 0, 0, 1, 0, 2, 1, 4
"d:\MyProject\Git项目中心\Github\WEB相关\iapp-doc\delete_book.php", "PHP", 32, 0, 0, 0, 10, 2, 44
"d:\MyProject\Git项目中心\Github\WEB相关\iapp-doc\edit_book.php", "PHP", 82, 0, 0, 0, 4, 3, 89
"d:\MyProject\Git项目中心\Github\WEB相关\iapp-doc\head.php", "PHP", 24, 0, 0, 0, 0, 1, 25
"d:\MyProject\Git项目中心\Github\WEB相关\iapp-doc\index.php", "PHP", 50, 0, 0, 0, 6, 3, 59
"d:\MyProject\Git项目中心\Github\WEB相关\iapp-doc\init.php", "PHP", 45, 0, 0, 0, 15, 3, 63
"d:\MyProject\Git项目中心\Github\WEB相关\iapp-doc\js\prism.js", "JavaScript", 0, 0, 0, 5, 2, 1, 8
"d:\MyProject\Git项目中心\Github\WEB相关\iapp-doc\login.php", "PHP", 65, 0, 0, 0, 4, 5, 74
"d:\MyProject\Git项目中心\Github\WEB相关\iapp-doc\logout.php", "PHP", 3, 0, 0, 0, 3, 2, 8
"d:\MyProject\Git项目中心\Github\WEB相关\iapp-doc\nav.php", "PHP", 34, 0, 0, 0, 1, 0, 35
"d:\MyProject\Git项目中心\Github\WEB相关\iapp-doc\public_fun.php", "PHP", 62, 0, 0, 0, 48, 2, 112
"d:\MyProject\Git项目中心\Github\WEB相关\iapp-doc\upload.php", "PHP", 135, 0, 0, 0, 34, 7, 176
"Total", "-", 729, 41, 1, 5, 154, 59, 989